111111111111111111111111111111111111111111111111111111111111111111111111111111111
111111111111111111111PC1111111111111111111111111111111111111111111111111111111111
1111111111111111111111E1111111111111111111111111111111111111111111111111111111111
111111111111111111111111111111111111111111111111111111111111111111111111111111111
111111111111111111111111111111111111111111111111111111111111111111111111111111111
111111111111111111111111111111111111111111111111111111111111111111111111111111111
111111111111111111111111111111111111111111111111111111111111111111111111111111111
